apfel : elma
see : deniz
teuer : pahali
billig : ucuz
dunkel : karanlik
glauben : inanmak
kleidung : kiyafet
blau : mavi
grun : yesil
bein : ayak
nur : only
gebaude : bina
plotzlich : suddenly
entspannend : rahatlatici
Hallo : Merhaba
Schwul : Gay
Lustig : Komik
Angst : Korku
verletzen : yaralamak
Entwicklung : Development
Hals : Bogaz
Weg : yol
Schule : Okul
nass : islak
trocken : kuru
messer : bicak
artz : doktor
fehler : hata
geduld : Sabir
mutig : cesur
sucht : bagimlilik
verstanden : anlamak
auswachen : uyku almak
tisch : masa
kopf : kafa
graben : kazmak
gesundheit : saglik
arm : fakir
reich : zengin
viel : cok